11111111111111111111111111111111111
1E0000000000000C00000C0000000000001
10100101001000001010010000000101001
10100100101010100010010000000101001
1PC000000C00C00000000000000000000C1
10100101001000001010010000000101001
11111111111111111111111111111111111
