1111111111111
1E11000000001
1C10011111001
1P0011E000001
1111111111111
