11111111111111111111111111111111111
1E0000000000000C00000C00000A0000001
10100101001000001010010000000101001
10100100101010100010010000000101001
1PC000A00C00CA0000000000000000000C1
1010010100100000101001000000A101001
11111111111111111111111111111111111
