1111111111111
1E11000000001
1C10011A11001
1P0011E000001
1111111111111
